*******************X***********X***************************X*****X***X*****************X*******X***X
**X*XXXX*XX*X*X*XX*XXX**X*XXXX*X*XXX*X***XXXXXXXX**X*XXX*XXX*X***X***XXX*XXX*X**XXX**X*X*XXX*X***X*X
***********X*****X*****X*****X***X*****************X***X*****X*X*******X*X*X*********X***X***X***X*X
*XXXXX*XXXXX*X*X*X*XXX*X*X*XXXX*XX*XXX*XXXXX***XXXXX***XXXXXXX**XX*XXX*X*X***XXX**X**XX*X****XXX*X*X
***X*******X*X***********X*X*****X*X***********X*****X***********X***X***X***X*********X***********X
XX*X*XXXXX*X*XXX*X**X*XXXX*X*X*X*X***X**XX**XXX**X*X*X*X*XX**X*XX*****XX**XX***X*XXXX**X*X*XX**X***X
*X*X*****X***X*X*****X***X***X*****X***********X*******X*******X*********X***********X*********X***X
***XXXXX***XXX*XXX*X*X*X*XXXXXXX*XXXXXX**XXXXX*X*XX**X***XXX*XXX*XXXXX*X*X*XXX*XX**X*XXXX**XXX*X*X*X
*******X*X*********X***X*****************X***************************************X*X*********X*****X
XXXXXXX****X*XXX*X*XXXX**XX**X*XXX*XXXXX*X*X*XXXXXXXX*XXX*XX*XX***XX***X*XXX*XX**X*XXX*X*XXX*X***X*X
*****X***X*X***X*X***X*******X*X*********X*X*************X*******X***X*****X*********X***X*****X*X*X
*******X***X***X*XX******X*XXX*X*X*XXX*X*X*XXXX*XX***X*XXX*XXX***X*X**XXXX*X*X**XXXX*******XXXXX*X*X
*X*****X***X*X***X***X*****X***X***X*****X*X*******X***X*****X*X***X***X***X*********X*X***********X
*XXX*XXX*XXX*XXXX**XX*XX*X*X*XXX*X*XX**XXX*X*X***XXX*X*****XX****XX*XX*X*XXXXX***X*X*X*XX*X******XXX
*********X***X*****X***X***X*****X*****X***X*****X***X*********X*****X*****X*****X*****X***********X
*X*X*XX*X***XX***X***X*XXXXXXXX**XXX*X***XX*X****X*XXX*X***X*XXX*XXX*X*XXX*X*XX*XXXXXXXX*X*X*X*XXX*X
***X*******X*****X*******************X*********X*X*X*****X*********X*****X***X***********X*****X***X
*X*X*X**XXXX*XX*XXXXX***XXXXXXX*X*XXX***X*XX*X*XX**X*XXX*X*X*X*X*X*XX**X*XXXX**XXX*X*X*X*X*XXXXX*XXX
*X*X*X***************X*X*********X***X*X*X***X***X*X*****X*X*X*****X***X*X***X*X***X*X*************X
*X*X*X*XXX*X*X*X*XXX*X***X*XXXXX*X***X***X*XX*XX*X*X*X**XX***XXXX*XX*X*X*XX**X*X***X*X*XXXXX*XXX*X*X
***************X*******X***X***X***X***X***X***X***X*X*X***X***********X***X*X*****X***X*****X*****X
XXXXXXX*XX**X**X*XXXXX*X*XX**X**XXX*X*X*X*XX***XX*XX***X*XXXX**X**XXXXXXXX*X***X*XXXXXXX**XXXX**XX*X
***X*****X*******X*******X***X***X*****X*****X*****X*********************X***X*****X*****X*********X
*X***XXX*X***XXX***X*X***X*X**XX*X*XXXXX*XXXX**X*X*X*X*X***XXXX*XXXXXXXX*XXXXXXXXX*X*XXXXX*XXXXX*X*X
*X*****X*****X***X*X*X*X*******X*X*********X*X***X***X***X***********X*X*X*******X***X*************X
*XXXX*XXXXXX*X*XXX*X*X*X***X*XXX*X***X*X*X*X*X****XX**XXX***XXXX*XXX***X*X***X*XXXXX*X*X*****X*XXX*X
***X*********X*****X*X***X*X***X*********X*************X*******X*****X*****X***X***X***X*****X***X*X
XX*X**X*X**XXXXXXXXX*XXXXX*XXX*X*****X*X**XX*XXXXX***X*X*XXX*****XXXXX*XXXXX**XX*****X*X*XXXX****X*X
*****X*********X***X*X*******X***X***X*****X*X*******X*X*X*****X***X*******X*****X*X***********X***X
*X*X*X*XXX*XXX*******X*X*XX*X*XXX*XXXX*XXX*X*****X*X*XXX***X***X*XXX*XX**X*X*XXXXX*X***XX**XXXX*XX*X
*****X*****X***X*X*X***X***X*********X*****X***X***X*****X*X*****X*******X***X***X***X*************X
XXXX*X***XXX*XXX***XXXXX*X***X*XXXX**XX*XXX**XXXX*X***XXX**X***X*X**X**X*X*X*X*X*X*XX**X**XX*X*X**XX
***X***X***X***X***X*****X*X*******X***********X***X*X*****X*****X*X*X*X*X*X*X*X*******X*X*X***X***X
*X*XXX*XXX*X*X**XX*X*XXX*X**XXXX****XX*XXX*X*X*X*X*X*X*XXXX*X*X**X*****X*X*X*X*XXX*X*X*****X*XXXX**X
*X***X***X*X***********X***X*****X***********X*******X*****X***X***X***X*X***X***********X*****X***X
*XXX*X***X*X*XXX*X*XX**X*****XXXXX***XXX*X*X*X*XX*XXXX**XX*X*X*XXX***XX**XXX**X*XXX*XXXXXXXXXXXX*XXX
***X***X***X***X*X*******X***X*******X***X***********X*******X*X*****************X*****************X
*X*XXX***XXXXX*X*X*X*XXX**X*****XXXX*X**XXXX*XXXXXXX*X*X*X*XXX****X****XXXXXXX*X*X**XXXXXX**XXXXXX*X
*********X*************X*******X***X*X*X***X*******X*****X*****X*X*X*X*********X*X***X*************X
*X***XXX****X*XXXX*X*X*XXX*X*XXX*X***X*X*X***X***XX*XX**XX*X*XXX*X*X*XXXXX***XXX*XXX***XXX*X***X*X*X
*******************X*X***X*********X***X*X*****X***************X***X***********X*X*X*X***X***X*X***X
*X*****X*****X**XXX**X*X*X****X*X**X*X*XXX*X*XX**XX*XXX*X*XXXX*XXXX**X*XXXXX**X**X***X*X*X*XX**XX**X
***X***X*******X*********X*******X*************X*****X*******X*****X*X*****X***X*X*X***X*X*X***X***X
XX**XX**X*X******XX*****XXX**X*X*XXXXX*XXXXXXX***XX****X*X*X*XX*X**X*XXXXXXX*X***X*XXXXX*X*X**X**XXX
*******X*************X*****X*****************X*********X***X*****X*X***********X*X*****X*X*******X*X
*XXXXX*X*XXX*XXXXXXX*X*X*X*X*XX***X*XXXXXXXX*XXX***XXXXXXX*X*XX**X***X*X*X*XXX*X*XXXX**X*X*X*X*X*X*X
*****X*******X*******X*******X***X*************X***X*********X***X*****X***********X***X*******X***X
*X*X*X*X*X*XXX**XXXXXX*XX**X*X*XXX*X*XXX*X*XX**X*XXX*XXX**XX*X*XXXXX*X*XXXXX*XXX*X****XX*X*X*X*X**XX
***X*X***X***X*******X*X***X*****X***********X*****X*****X***********X*******X*****X*****X***X*X***X
*XXXXXXXXXXX***X***X***X**XX*XXX***X*X*XXXXX*XXXX***XXXX*X*X*XXX*X*XXXXX***X*XX*XX*X***XX**X*X*X*X*X
*************X***X***X*X*******X*X***X***X*X***********X*****X***X*********X*******X*X*X***X*X***X*X
*XXXXXXX**XXXX*XXX*XX***XX*XXX*X**XXXX*X*X*XXXX*XXXXXX**XX*X*X*XXX**X*X*XX*XXX*XXX*X*****XXX*XXXXX*X
***X*************X*************X*********X*******X***X***X*X*X*X*************X*X***X*X***X***X*****X
*X*X*X*XX*XXXX*X*XX*XX*X*XXX****XXX*XX*X*X***X*X*X*X*XXX*X*X*X*X*X*XXXXXXXXX****XXXX*XXXXX*XX**XXX*X
*X***X***X*****X*****X***X*****************X*X***X*X*X*X*X*******X***X*******X*****X*X***X*********X
***XXXXX*X*X*XXXXXXX*X**X**X*XXX**XX*XX*X*X**X***X*X*X*X*XXX*XXXXXX****X*X**XX**XX*X*X*X*X***XXX*X*X
*********X***X*X*****X*************X*****X***X***X*X*X***************X*X*****X*******X*X*********X*X
XXXXXX*X*XX*XX*X*XXX***X***X**XXXX*X*XXX*XX*XX***X*X*X*XXXXXXXXX*X**XX*X*X*X*X**X*XXXX*X*X*X****XX*X
*****X***X*********X*****X*X*X*********X*****X*****X*****************X*X***X*X*******X*X***X***X*X*X
*X**XXXXXX***XX*X**X*XX*XX***X***XXX**XXXXXX**X*XX***X**XXXX*X*XXXXX***X*X*X*XX**XXX***X*XX*XXXX*X*X
***********X*****X*X*X*****X*X*******X***X*X***X*****X*X*X*********X*X*X*****X*****X***************X
*XXXXXX*XX*X*XXX*X*X*X*XX*XX*X*X*XXX*X***X*XXX*X*X*XX**X***XX*XXXX*X*X*X*X*X*X**XX*X*X**X*XX****X*XX
***X***X***X*****X*X*X*************X***X*****X***X*********X*******X*X***X*****X*X*****X***X*X*****X
XX*X*X*X*X**X*XX*XXX**XXXXXXXXXXXX*X***X*X*X*****X***X*XXXX****X*XXX*X**XXX*XX*X*X**XX***X*X*XXX*X*X
***X*X***X*X***X*****X*******X***X*X*********X*X*X*X***X***X*X*******X*********X***X*X***X***X*X***X
**X**XX*XX*X*X*X***XXX*X***X*X*X*X*XXXXX**XX*X*X*X*XX*XX*X*X*X**XX**XX*X*XXX*X*XXXX**X*XXX**XX*X*XXX
*X***X*****X***************X***X*X***********X*X***X*****X*X*****X*X*********X*********************X
****XX**XXXX*X*XXXX*XXXX*XX*XXX**X*X*XXXXXXX*X****XX*XX**X*X*X*X*X****XX*XXXX*XXXXXX******XX*XXXXX*X
*****X*X*****X*********X*X*******X***X*********X*****X*******X*X***X*X*X*********X***X*****X***X***X
***X*X*X**XXX**X*X***X*X**XXXXX*X*XXXX*XXX*XX**X*X*XXX*X*XX*XX**XXXX*X*X***X*XXX*****X*X*X*X***X**XX
***X*X*X*X***********X*X*************X*X*******X*X***********X***X***X***X*X***X*******X*******X***X
*X*XXX*X*X*****XXX*X**X*XX*X***X*XX**X*X*XXX**XX*X*XXXXX**XX*XXX*X*XXXXXXX*X*X*X*XXXX**X*XXX*X*XXX*X
*X*****X*X*X*X***X*X*X*************************X*X*****************X*****X*******X*************X***X
*X*XXXXX*X*****X***X****X****XX*XX*X*X*X*X*X*X*X*X*XXX*XXX*XXXXXXXXX*X**X*XX**X****X*X*X*X*X*XXX***X
*X*****X*X*X*X*X***X***X*********X***X***X***X*X*****X*X*****X***X***X*****X***X***X***X*X*X***X***X
*X**XX*X*X*X****XXXX**X**XXXXX*X*XXX*XXX*XXX*XXX*X*X*X*X*X*XX****X*XXXXXXX*X*X*X*XXXXXXX*X***X**XX*X
*****X***X***********X*******X***X*X***X***********X*****X***************X***X***********X***X*****X
**XX*XXXXXXXXXXXXXX**X*XXXXX*X*XX**X***XXXX*XXX*XX*X**XX*X*XXXXX*XXX*XXX*XX*XXXXXXXXXX*XXXXXXXXX*XXX
*****X***X*******X***X*****X*****************X*****X***X***X*********X***X***X***********X*********X
***XX**X***X*XXX*X*XX***XX*XXXX**XXX**X**X*X***XX*XX*X*XX*X**XX*XX*X***XXX*X*X**XXXXX*XX*X*X*XXXXX*X
*X*X***X*******X*X*****X*X*****X***X*****X*X*X*****X*X*******X*X***X*************X*********X***X***X
*X***XXX*XXX*X***XX*XXXX*****XXX**XXX*X**X*X*XXX*X*X**XXXXX*XX*X*XX**XX*XXXX*XXX*****X*XXX*XXX*X*XXX
***X*X*********X*******X*********X*********X***X***************X*X*X*X*****X***X***X*****X*****X***X
**XX*X**XXXX*X*X*X*XXX*XXXXXXX*X*X***X****XXX**X*XX**XXX*X*X*X*X*X*X*X**XX***X*X**XX*X*X***X*X***XXX
*********X***X*X*************X***X*****X*******************X*X***X***X***X*X***X*****X*****X***X***X
X**X*X*X*X*X*XXX*X*XXXXX*XXX*XXXXXXXX**X*X**XXXX*XXX*XXX**XX*XX*XXX*XXXX*X**********XXX***XX*X*X*X*X
*****X*X***X*X***X*****X***************X*************X*****X*****X*****X*X*X*X***X*****X*******X*X*X
*XXX***X*XXXXX*X***XX**XXX**XXXXXX*X*XXXXXX**X**XXXXXX*XX*X*X**X***X*X***X*X*XXX*X*XXXXX*XXXXXXX*X*X
***X*X*********X*****X***************************X*******X***********X*X*X*X*******X***X*******X***X
*X*X*XXX*XXX*XXX**XX**XX**X**X***X*XX*XXXX*XXXXX***X*XXX*X*XXXXXX*XX*X*X*X*X*XXX*XXX*X**X***XX*XXXXX
***X***X*******X***X*********X*************X***X*********X*********X*************X***X*****X*******X
**X*XX***XXXXX*X*******X**X**XXXXXXXXXXXXX*X*X*XXXX**XX*XXXX**X***XX*X*X*XX*XXXX*X**XX*X*XX***X**X*X
***X*********X*X*****X***********X*****X***X*X*****************X*******X*******X*****X***X***X*****X
XX*X*X*X***X*X*X*XXX*XX*XX*X*X*XXX*X**XX*X**XX*X*XXXXXX**XX******XXXX**X**XXXX*XXXXX***X*X*XXX*X*XXX
***X*****X*X*X***X***X***X***X*****X***X*X*****X*********X*X*****************X*X***X*X*X*X*********X
**XXXX***X*X**X*XX*XXX*X*XX**XXXXX*X*X*X***XXX*XXXXXXXXXXX***XXXX*XX*XXXXX*X*X*X*X***X*X*XXXXXXX*X*X
*X*********X*X*****X***X*****X***X***X*****************X*****X***********X*****X*X***X***X*******X*X
*X*X*X**XXX*XX*XXX****XXXXXXXX*X*X*X*XXX******XXXXX*X**X**XXXX*X*X***X*X*XX*XX*X**XXXX**XX*XX*XXXX*X
***X*******************************X*****************X*****************X*******X***********X********
XXXXXXXXXXXXXXXXXXXXXXXXXXXXXXXXXXXXXXXXXXXXXXXXXXXXXXXXXXXXXXXXXXXXXXXXXXXXXXXXXXXXXXXXXXXXXXXXXXX*